let ASIM_Corelight_http2 = view () {
	Corelight_v2_http2_CL
	| project-rename
		_path=_path_s,
		_system_name=_system_name_s,
		_write_ts=_write_ts_t,
		Uid=uid_s,
		SrcIpAddr=id_orig_h_s,
		SrcPort=id_orig_p_d,
		DstIpAddr=id_resp_h_s,
		DstPort=id_resp_p_d,
		stream_id=stream_id_d,
		HttpRequestMethod=method_s,
		HttpRequestHeaderHost=host_s,
		UrlOriginal=uri_s,
		HttpReferrerOriginal=referrer_s,
		Version=version_s,
		UserAgentOriginal=user_agent_s,
		HttpRequestBodyBytes=request_body_len_d,
		HttpResponseBodyBytes=response_body_len_d,
		HttpStatusCode=status_code_d,
		HttpStatusMessage=status_msg_s,
		HttpInformationalCode=info_code_d,
		HttpInformationalMessage=info_msg_s,
		encoding=encoding_s,
		Username=username_s,
		UserPassword=password_s,
		HttpProxiedHeaders=proxied_s,
		push=push_b
	| extend
		EventVendor="Corelight",
		EventProduct="CorelightSensor",
		EventType="http2"
};
ASIM_Corelight_http2

