let ASIM_Corelight_dns = view () {
	Corelight_v2_dns_CL
	| project-rename
		_path=_path_s,
		_system_name=_system_name_s,
		_write_ts=_write_ts_t,
		Uid=uid_s,
		SrcIpAddr=id_orig_h_s,
		SrcPort=id_orig_p_d,
		DstIpAddr=id_resp_h_s,
		DstPort=id_resp_p_d,
		proto=proto_s,
		DnsTransactionId=trans_id_d,
		DnsRtt=rtt_d,
		DnsQueryName=query_s,
		DnsQueryClass=qclass_d,
		DnsQueryClassName=qclass_name_s,
		DnsQueryType=qtype_d,
		DnsQueryTypeName=qtype_name_s,
		DnsResponseCode=rcode_d,
		DnsResponseCodeName=rcode_name_s,
		DnsFlagsAuthoritative=AA_b,
		DnsFlagsTruncated=TC_b,
		DnsFlagsRecursionDesired=RD_b,
		DnsFlagsRecursionAvailable=RA_b,
		DnsFlagsZ=Z_d,
		DnsResponseName=answers_s,
		DnsResponseTtl=TTLs_s,
		DnsRejected=rejected_b
	| extend
		EventVendor="Corelight",
		EventProduct="CorelightSensor",
		EventType="dns"
};
ASIM_Corelight_dns

