let ASIM_Corelight_x509 = view () {
	Corelight_v2_x509_CL
	| project-rename
		_path=_path_s,
		_system_name=_system_name_s,
		_write_ts=_write_ts_t,
		fingerprint=fingerprint_s,
		CertificateVersion=certificate_version_d,
		CertificateSerial=certificate_serial_s,
		CertificateSubject=certificate_subject_s,
		CertificateIssuer=certificate_issuer_s,
		CertificateNotValidBefore=certificate_not_valid_before_t,
		CertificateNotValidAfter=certificate_not_valid_after_t,
		CertificateKeyAlg=certificate_key_alg_s,
		CertificateSigAlg=certificate_sig_alg_s,
		CertificateKeyType=certificate_key_type_s,
		CertificateKeyLength=certificate_key_length_d,
		CertificateExponent=certificate_exponent_s,
		CertificateCurve=certificate_curve_s,
		SanDns=san_dns_s,
		SanUri=san_uri_s,
		SanEmail=san_email_s,
		SanIp=san_ip_s,
		BasicConstraintsCa=basic_constraints_ca_b,
		BasicConstraintsPathLen=basic_constraints_path_len_d,
		host_cert=host_cert_b,
		client_cert=client_cert_b
	| extend
		EventVendor="Corelight",
		EventProduct="CorelightSensor",
		EventType="x509"
};
ASIM_Corelight_x509

