let ASIM_Corelight_files = view () {
	Corelight_v2_files_CL
	| project-rename
		_path=_path_s,
		_system_name=_system_name_s,
		_write_ts=_write_ts_t,
		ZeekIdFuid=fuid_s,
		TxHosts=tx_hosts_s,
		RxHosts=rx_hosts_s,
		ZeekIdConnUids=conn_uids_s,
		Source=source_s,
		Depth=depth_d,
		ZeekFilesAnalyzers=analyzers_s,
		MimeType=mime_type_s,
		FileName=filename_s,
		EventDuration=duration_d,
		ZeekConnLocalSrc=local_orig_b,
		IsOrig=is_orig_b,
		ZeekFilesSeenBytes=seen_bytes_d,
		TotalBytes=total_bytes_d,
		ZeekFilesMissingBytes=missing_bytes_d,
		ZeekFilesOverflowBytes=overflow_bytes_d,
		ZeekFilesTimedout=timedout_b,
		ZeekIdParentFuid=parent_fuid_s,
		HashSha1=sha1_s,
		HashSha256=sha256_s,
		ZeekFilesExtracted=extracted_s,
		ZeekFilesExtractedCutoff=extracted_cutoff_b,
		ZeekFilesExtractedSize=extracted_size_d
	| extend
		EventVendor="Corelight",
		EventProduct="CorelightSensor",
		EventType="files"
};
ASIM_Corelight_files

