let ASIM_Corelight_ssh = view () {
	Corelight_v2_ssh_CL
	| project-rename
		_path=_path_s,
		_system_name=_system_name_s,
		_write_ts=_write_ts_t,
		Uid=uid_s,
		SrcIpAddr=id_orig_h_s,
		SrcPort=id_orig_p_d,
		DstIpAddr=id_resp_h_s,
		DstPort=id_resp_p_d,
		Version=version_d,
		AuthSuccess=auth_success_b,
		AuthAttempts=auth_attempts_d,
		Direction=direction_s,
		Client=client_s,
		Server=server_s,
		CipherAlg=cipher_alg_s,
		MacAlg=mac_alg_s,
		CompressionAlg=compression_alg_s,
		KexAlg=kex_alg_s,
		HostKeyAlg=host_key_alg_s,
		HostKey=host_key_s,
		RemoteLocationCountryCode=remote_location_country_code_s,
		RemoteLocationRegion=remote_location_region_s,
		RemoteLocationCity=remote_location_city_s,
		RemoteLocationLatitude=remote_location_latitude_d,
		RemoteLocationLongitude=remote_location_longitude_d,
		Hasshversion=hasshVersion_s,
		Cshka=cshka_s,
		Hasshalgorithms=hasshAlgorithms_s,
		sshka=sshka_s,
		Hasshserveralgorithms=hasshServerAlgorithms_s,
		inferences=inferences_s
	| extend
		EventVendor="Corelight",
		EventProduct="CorelightSensor",
		EventType="ssh"
};
ASIM_Corelight_ssh

