let ASIM_Corelight_ftp = view () {
	Corelight_v2_ftp_CL
	| project-rename
		_path=_path_s,
		_system_name=_system_name_s,
		_write_ts=_write_ts_t,
		Uid=uid_s,
		SrcIpAddr=id_orig_h_s,
		SrcPort=id_orig_p_d,
		DstIpAddr=id_resp_h_s,
		DstPort=id_resp_p_d,
		User=user_s,
		UserPassword=password_s,
		FtpProcessName=command_s,
		FtpCommandLine=arg_s,
		MimeType=mime_type_s,
		FileSize=file_size_d,
		ReplyCode=reply_code_d,
		ReplyMsg=reply_msg_s,
		DataChannelPassive=data_channel_passive_b,
		DataChannelOrigH=data_channel_orig_h_s,
		DataChannelRespH=data_channel_resp_h_s,
		DataChannelRespP=data_channel_resp_p_d,
		ZeekIdFuid=fuid_s
	| extend
		EventVendor="Corelight",
		EventProduct="CorelightSensor",
		EventType="ftp"
};
ASIM_Corelight_ftp

