let ASIM_Corelight_smtp = view () {
	Corelight_v2_smtp_CL
	| project-rename
		_path=_path_s,
		_system_name=_system_name_s,
		_write_ts=_write_ts_t,
		Uid=uid_s,
		SrcIpAddr=id_orig_h_s,
		SrcPort=id_orig_p_d,
		DstIpAddr=id_resp_h_s,
		DstPort=id_resp_p_d,
		ZeekHttpTransDepth=trans_depth_d,
		Helo=helo_s,
		Mailfrom=mailfrom_s,
		Rcptto=rcptto_s,
		Date=date_s,
		From=from_s,
		To=to_s,
		Cc=cc_s,
		ReplyTo=reply_to_s,
		MsgId=msg_id_s,
		InReplyTo=in_reply_to_s,
		Subject=subject_s,
		XOriginatingIp=x_originating_ip_s,
		FirstReceived=first_received_s,
		SecondReceived=second_received_s,
		LastReply=last_reply_s,
		ShareName=path_s,
		UserAgentOriginal=user_agent_s,
		Tls=tls_b,
		Fuids=fuids_s,
		IsWebmail=is_webmail_b,
		urls=urls_s,
		domains=domains_s
	| extend
		EventVendor="Corelight",
		EventProduct="CorelightSensor",
		EventType="smtp"
};
ASIM_Corelight_smtp

