let ASIM_Corelight_suricata_corelight = view () {
	Corelight_v2_suricata_corelight_CL
	| project-rename
		_path=_path_s,
		_system_name=_system_name_s,
		_write_ts=_write_ts_t,
		Uid=uid_s,
		SrcIpAddr=id_orig_h_s,
		SrcPort=id_orig_p_d,
		DstIpAddr=id_resp_h_s,
		DstPort=id_resp_p_d,
		icmp_type=icmp_type_d,
		icmp_code=icmp_code_d,
		SuricataId=suri_id_s,
		Service=service_s,
		FlowId=flow_id_d,
		TransactionId=tx_id_d,
		PcapCount=pcap_cnt_d,
		alert_action=alert_action_s,
		AlertGroupId=alert_gid_d,
		AlertSignatureId=alert_signature_id_d,
		AlertRevision=alert_rev_d,
		AlertSignature=alert_signature_s,
		AlertCategory=alert_category_s,
		AlertSeverity=alert_severity_d,
		AlertMetadata=alert_metadata_s,
		FingerprintNetworkCommunityId=community_id_s,
		payload=payload_s,
		packet=packet_s,
		metadata=metadata_s
	| extend
		EventVendor="Corelight",
		EventProduct="CorelightSensor",
		EventType="suricata_corelight"
};
ASIM_Corelight_suricata_corelight

