let ASIM_Corelight_notice = view () {
	Corelight_v2_notice_CL
	| project-rename
		_path=_path_s,
		_system_name=_system_name_s,
		_write_ts=_write_ts_t,
		Uid=uid_s,
		SrcIpAddr=id_orig_h_s,
		SrcPort=id_orig_p_d,
		DstIpAddr=id_resp_h_s,
		DstPort=id_resp_p_d,
		ZeekIdFuid=fuid_s,
		FileMimeType=file_mime_type_s,
		FileDesc=file_desc_s,
		proto=proto_s,
		Note=note_s,
		Msg=msg_s,
		Sub=sub_s,
		Src=src_s,
		Dst=dst_s,
		P=p_d,
		N=n_d,
		PeerDescr=peer_descr_s,
		Actions=actions_s,
		suppress_for=suppress_for_d,
		RemoteLocationCountryCode=remote_location_country_code_s,
		RemoteLocationRegion=remote_location_region_s,
		RemoteLocationCity=remote_location_city_s,
		RemoteLocationLatitude=remote_location_latitude_d,
		RemoteLocationLongitude=remote_location_longitude_d,
		severity_level=severity_level_d,
		severity_name=severity_name_s
	| extend
		EventVendor="Corelight",
		EventProduct="CorelightSensor",
		EventType="notice"
};
ASIM_Corelight_notice

